Грязный - Dirty
Большой - Big
Женщина - Woman
Счастливый - Happy
Красный - Red
Зеленый - Green
Дом - House
Холодный - Cold
Горячий - Hot
Маленький - Small
Новый - New
Старый - Old
Голодный - Hungry
Сытый - Full
Быстрый - Fast
Медленный - Slow
Смешной - Funny
Серьезный - Serious
Громкий - Loud
Тихий - Quiet
Простой - Simple
Сложный - Complex
Красивый - Beautiful
Уродливый - Ugly
Легкий - Light
Тяжелый - Heavy
Веселый - Fun
Скучный - Boring
Здоровый - Healthy
Больной - Sick
Прямой - Straight
Кривой - Crooked
Трудный - Difficult
Легкий - Easy
Сладкий - Sweet
Горький - Bitter
Смутный - Confused
Ясный - Clear
Темный - Dark
Светлый - Bright