Высокий - Tall
Низкий - Short
Широкий - Wide
Узкий - Narrow
Жаркий - Hot
Холодный - Cold
Мокрый - Wet
Сухой - Dry
Чистый - Clean
Грязный - Dirty
Свободный - Free
Занятый - Busy
Легкий - Light
Тяжелый - Heavy
Круглый - Round
Квадратный - Square
Тонкий - Thin
Толстый - Thick
Мягкий - Soft
Жесткий - Hard
Быстрый - Fast
Медленный - Slow
Старый - Old
Новый - New
Долгий - Long
Короткий - Short
Простой - Simple
Сложный - Complex
Строгий - Strict
Гибкий - Flexible
Круглый - Round
Острый - Sharp
Тупой - Dull
Прозрачный - Transparent
Непрозрачный - Opaque
Просторный - Spacious
Тесный - Cramped
Активный - Active
Пассивный - Passive
Бодрствующий - Awake