Полезный - Useful
Бесполезный - Useless
Очевидный - Obvious
Неочевидный - Non-obvious
Опасный - Dangerous
Безопасный - Safe
Точный - Accurate
Неточный - Inaccurate
Прозрачный - Transparent
Непрозрачный - Opaque
Внутренний - Internal
Внешний - External
Активный - Active
Пассивный - Passive
Творческий - Creative
Рутинный - Routine
Глобальный - Global
Локальный - Local
Личный - Personal
Общественный - Public
Продвинутый - Advanced
Начальный - Initial
Развитый - Developed
Неразвитый - Undeveloped
Гармоничный - Harmonious
Дисгармоничный - Disharmonious
Оригинальный - Original
Клише - Cliché
Исключительный - Exclusive
Обычный - Ordinary
Инновационный - Innovative
Устаревший - Outdated
Актуальный - Relevant
Неактуальный - Irrelevant
Эффективный - Effective
Бесполезный - Ineffective
Устойчивый - Sustainable
Неустойчивый - Unstable
Вдохновляющий - Inspiring
Банальный - Banal