Важный - Important
Неважный - Unimportant
Счастливый - Happy
Несчастный - Unhappy
Интересный - Interesting
Скучный - Boring
Легкий - Easy
Трудный - Difficult
Умный - Smart
Глупый - Stupid
Легкий - Light
Тяжелый - Heavy
Молодой - Young
Старый - Old
Быстрый - Fast
Медленный - Slow
Чистый - Clean
Грязный - Dirty
Тихий - Quiet
Громкий - Loud
Близкий - Close
Далекий - Far
Широкий - Wide
Узкий - Narrow
Круглый - Round
Угловатый - Angular
Прямой - Straight
Кривой - Curved
Простой - Simple
Сложный - Complex
Свободный - Free
Занятый - Busy
Свободный - Available
Занятый - Occupied
Верхний - Upper
Нижний - Lower
Внутренний - Inner
Внешний - Outer
Ясный - Clear
Темный - Dark